Job Interview - Entrevista de Emprego
Middle Name / Last Name - Nome do meio / Ultimo nome
Can you spell your last name? - Voce poderia soletrar seu Ultimo nome?
Polite - Educado
Age - Idade
Am - Ser ou Estar
What do you do? - O que voce faz?
An ("n" in "an") - Serve para dar ritmo na frase. Utilizado antes de palavras que comecam com vogal
This is worng - Isto esta errado
Do you mean - Voce quer dizer
Mean - Significar
Devices - Dispositivos
Environment - Ambiente
Self-Improvement - Desenvolvimento pessoal
Challenges - Desafios
Yet - Ainda
Exchange - Troca
Full time - O tempo todo
Practice - Praticar
You're welcome - De nada
You can call me - Voc� pode me chamar de
Learning Target - Meta de aprendizado
Greetings - Cumprimento/Sauda��es
Is the same - � a mesma coisa
I'm doing good  - Estou bem / Estou indo bem
Good morning - Bom dia
Good Night - Boa noite
Good evening - Boa noite - Usado para quando a pessoa est� chegando no lugar
Going - Going on - indo - acontecendo
Comes - Vem
Glad - Alegre
Was  - Era
It was nice to see you - Foi bom ver voc�
It was - = Verbo no passado
See you soon - Te vejo em breve
See you later - Te vejo mais tarde
Take care - Se cuida
What's up - E ai
Neat - Algo como "Legal"
Bath - Banho
We - N�s
Assignments done - Tarefas feitas
Somebody - Algu�m
About - Sobre
Parents  - Pais
Relatives - Parentes
Married - Casado(a)
Single - Solteiro(a)
Boyfriend / Girlfriend - Namorado / Namorada
Groom / Fiance - Noivo(a)
Truly - Verdadeiramente
Husband - Marido
Wife - Esposa
Daughters - Filhas
The Youngest - A mais nova
The Oldest - A mais velha
Handsome - Bonito(a)
Siblings - Irm�os (sem especificar o sexo)
Pace - Ritmo
I grew up - Eu cresci
Grow - Crescer (Grew � o passado de Grow)
Sure - Claro
Son  - Filho
Sisterhood - Irmandade
Neighborhood - Vizinhan�a
